1 1 1 1 1 1 1 1 1 1 1 1 1 1 1 1 1 1 1 1
1 1 3 3 3 3 3 3 3 3 3 3 3 3 3 3 3 3 1 1
1 1 3 6 2 5 2 6 2 6 2 2 6 5 2 2 9 3 1 1
1 1 3 2 3 3 3 2 3 2 3 3 2 3 3 3 2 3 1 1
1 1 3 2 3 3 3 2 3 6 2 2 6 2 2 2 6 3 1 1
1 1 3 2 3 3 3 2 3 2 3 3 3 3 3 3 2 3 1 1
3 3 3 6 2 2 2 6 5 6 2 2 2 2 6 2 6 3 3 3
2 2 2 2 3 3 3 2 3 2 3 3 3 3 2 3 2 2 2 2
3 3 3 2 2 0 2 2 3 2 3 3 3 3 2 3 2 3 3 3
1 1 3 2 3 3 3 2 3 2 3 3 3 3 2 3 2 3 1 1
1 1 3 5 3 3 3 2 3 6 2 2 2 2 6 5 6 3 1 1
1 1 3 2 3 3 3 2 3 2 3 3 3 3 3 3 2 3 1 1
1 1 3 6 2 2 2 6 2 6 2 5 2 2 2 2 6 3 1 1
1 1 3 3 3 3 3 3 3 3 3 3 3 3 3 3 3 3 1 1
1 1 1 1 1 1 1 1 1 1 1 1 1 1 1 1 1 1 1 1